1111111111110
1001000000LC1
1000011111001
1P0011E000001
1111111111111