1111111111110
10011000000C1
100R011111001
1P0011E000001
1111111111111