11111111111111
1001000L0000C1
10000111110001
11101110010101
100000E00100C1
1000011111C101
1P0011E0000001
11111111111111