1111111111111
1000000000001
1001111C11101
1P1011E000001
1111111111111